AAAAAAAAAAAAAAAAAAAAAAAAAAAAAAAAAAAAAAAAAAA
AAACCCAAAAAAAAAADAAAAAAAAAAAAAEFAAAAAAAAAAA
AAAAAAAAAAAAAAAAAAAAAAAAAAAAAAAAAAAAAAAAAAA
AAAAAAAAAEEEAAAAAAAAAAABBBBBLBBBMAAAAAAAAAA
AAAAAAAAAAAAAAAAAAAAAAABBKBBBBKBBAAAAAAAAAA
AAAAAAAAAAAAAAAAAAAAAAABJBBBLBBKBAAAAAAAAAA
AAAAAAAAAAAAAAAAAAAAAAABBMBBLBKBBAAAAAAAAAA
AAAAAAAAAAAAAAAGGGHHAAABBMBBBBLBMAAAAAAAAAA
AAAAAAAAAAAAAAAAAAAAADAAAAAAAAAAAAAAAAAAAAA
AAAAAAAAAAAAAAAAAAAAAAAAAAAAAAAAAAHAAAAAAAA
AAAAAGAAAAAAAAAAAAAAAAAAAAAAAAAAAAAAAAAAAAA
AAAAAAAAAAADAAAAAAAAAAAAAAAEIAAAAAAAAAAAAAA
AAAAAAAAAAAAAAAAAAAAAAAAAAAAAAAAAAAAAAAAAAA
AAAAAAFFAAAAAAAAAAAAAAAAAAAAAAAAAAAAAEAAAAA
AAAAAAAAAAAAAAAAACAIIAAAAAAADAAAAAAAAAAAAAA
AAAAAAAAAAAAAAAAAAAAAAAAAAADAAAAAAAAAAAAAAA