AAAAAAAAAAAAAAAAAAAAAAAAAAAAAAAAAAAAAAAAAAA
AAACCCAAAAAAAAAADAAAAAAAAAAAAAEFAAAAAAAAAAA
AAAAAAAAAAAAAAAAAAAAAAAAAAAAAAAAAAAAAAAAAAA
AAAAAAAAAEEEAAAAAAAAAAABBBBBBBBBBAAAAAAAAAA
AAAAAAAAAAAAAAAAAAAAAAABBBBBBBKBBAAAAAAAAAA
AAAAAAAAAAAAAAAAAAAAAAABJBBBBBBBBAAAAAAAAAA
AAAAAAAAAAAAAAAAAAAAAAABBBBBBBBBBAAAAAAAAAA
AAAAAAAAAAAAAAADDDDDAAABBMBBBBLBBAAAAAAAAAA
AAAAAAAAAAAAAAAAAAAAADAAAAAAAAAAAAAAAAAAAAA
AAAAAAAAAAAAAAAAAAAAAAAAAAAAAAAAAAHAAAAAAAA
AAAAAGAAAAAAAAAAAAAAAAAAAAAAAAAAAAAAAAAAAAA
AAAAAAAAAAADAAAAAAAAAAAAAAAAEIAAAAAAAAAAAAA
AAAAAAAAAAAAAAAAAAAAAAAAAAAAAAAAAAAAAAAAAAA
AAAAAAAAAAAAAAAAAAAAAAAAAAAAAAAAAAAAAEAAAAA
AAAAAAAAAAAAAAAAACAIIAAAAAAADAAAAAAAAAAAAAA
AAAAAAAAAAAAAAAAAAAAAAAAAAADAAAAAAAAAAAAAAA