AAAAAAAAAAAAAAAAAAAAAAAAAAAAAAAAAAAAAAAAAAA
AAACCCAAAAAAAAAADAAAAAAAAAAAAAEFAAAAAAAAAAA
AAAAAAAAAAAAAAAAAAAAAAAAAAAAAAAAAAAAAAAAAAA
AAAAAAAAAEEEAAAAAAAAAAABBBBBLBBBMAAAAAAAAAA
AAAAAAAAAAAAAAAAAAAAAAABBKBBBBKBBAAAAAAAAAA
AAAAAAAAAAAAAAAAAAAAAAABJBBBLBBKBAAAAAAAAAA
AAAAAAAAAAAAAAAAAAAAAAABBMBBLBKBBAAAAAAAAAA
AAAAAAAAAAAAAAAGGGHHAAABBMBBBBLBMAAAAAAAAAA
AAAAAAAAAAAAAAAAAAAAADAAAAAAAAAAAAAAAAAAAAA
AAAAAAAAAAAAAAAAAAAAAAAAAAAAAAAAAAHAAAAAAAA
AAAAAGAAAAAAAAAAAAAAAAAAAAAAAAAAAAAAAAAACAA
AAAAAAAAAAADAAAAAAAAAAAAAAAAEIAAAAAAAAAAAAA
AAAAAAAAAAAAAAAAAAAAAAAAAAAAAAAAAAAAAAAAAAA
AAAAAAAECAAAAAAAAAAAAAAAAAAAAAAAAAAAAAEAAAA
AAAAAAAAAAAAAAAAACAIIAAAAAAADAAAAAAAAAAAAAA
AAAAAAAAAAAAAAAAAAAAAAAAAAADAAAAAAAAAAAAAAA